0 0 0 0 0 0 0 0 0 0 0
0 R 0 0 0 0 0 R 0 0 0
L 0 0 0 0 0 L 0 L 0 0
0 0 0 0 0 0 0 0 0 0 0
0 0 0 0 L L 0 0 L L L
0 0 0 0 0 0 0 0 0 0 0
R R R 0 0 0 0 0 R 0 0
0 0 0 0 0 0 0 0 0 0 0
0 0 0 L 0 0 0 0 L 0 0
0 0 R 0 0 R 0 R 0 0 0
0 R 0 R 0 0 R 0 0 0 R
0 0 0 0 0 0 0 0 0 0 0
0 L 0 0 L L 0 0 L L L
0 0 0 0 0 0 0 0 0 0 0
0 0 0 0 0 0 0 0 0 0 0
0 0 L 0 0 L 0 0 0 L L
0 R 0 R 0 0 0 R R R 0
0 L L 0 0 0 L 0 L 0 0
0 0 0 0 0 0 0 0 0 0 0
R R R R R 0 0 0 R R R
0 0 0 0 0 0 0 0 0 0 0